,------.                                
|  .--. ' ,---. ,---. ,--,--,--. ,---.  
|  '--'.'| .-. | .-. ||        |(  .-'  
|  |\  \ ' '-' ' '-' '|  |  |  |.-'  `) 
`--' '--' `---' `---' `--`--`--'`----'  